"aa" = (/turf/simulated/mineral,/area/template_noop)
"ab" = (/turf/template_noop,/area/template_noop)
"ac" = (/obj/structure/grille,/turf/simulated/floor/plating)
"ad" = (/obj/random/trash,/mob/living/simple_animal/hostile/mining_borg/behemoth,/turf/simulated/floor/tiled)
"ae" = (/obj/item/ore/slag,/turf/simulated/floor/plating,/area/template_noop)
"af" = (/turf/simulated/floor/plating)
"ag" = (/obj/item/ore/slag,/turf/simulated/floor/plating)
"ah" = (/obj/effect/decal/cleanable/dirt,/turf/simulated/floor/tiled)
"ak" = (/obj/structure/bed/chair{dir = 1},/turf/simulated/floor/tiled)
"al" = (/turf/simulated/wall/r_wall,/area/template_noop)
"am" = (/obj/item/ore/slag,/obj/effect/decal/cleanable/dirt,/turf/simulated/floor/tiled)
"an" = (/obj/structure/table/steel_reinforced,/obj/random/firstaid,/turf/simulated/floor/tiled)
"ao" = (/obj/structure/table/steel_reinforced,/obj/machinery/light{dir = 8; icon_state = "tube1"; pixel_y = 0},/turf/simulated/floor/tiled)
"ap" = (/obj/effect/decal/cleanable/blood,/turf/simulated/floor/tiled)
"aq" = (/obj/structure/table/steel_reinforced,/obj/machinery/light{icon_state = "tube1"; dir = 4},/turf/simulated/floor/tiled)
"ar" = (/turf/simulated/wall/r_wall)
"as" = (/obj/structure/table/steel_reinforced,/obj/random/handgun,/obj/effect/decal/cleanable/blood,/turf/simulated/floor/tiled)
"at" = (/obj/effect/decal/cleanable/dirt,/obj/effect/decal/cleanable/blood,/turf/simulated/floor/tiled)
"au" = (/obj/machinery/door/firedoor,/obj/structure/grille,/obj/structure/window_frame,/turf/simulated/floor/tiled,/area/template_noop)
"av" = (/obj/effect/decal/cleanable/dirt,/obj/effect/decal/cleanable/dirt,/turf/simulated/floor/tiled)
"aw" = (/obj/structure/table/steel_reinforced,/turf/simulated/floor/tiled)
"ax" = (/obj/random/trash,/turf/simulated/floor/tiled)
"ay" = (/obj/structure/bed/chair{icon_state = "chair_preview"; dir = 8},/obj/effect/landmark/corpse/bridgeofficer,/turf/simulated/floor/tiled)
"az" = (/obj/structure/bed/chair{dir = 4},/turf/simulated/floor/tiled)
"aA" = (/obj/structure/table/steel_reinforced,/obj/item/storage/fancy/cigarettes/killthroat,/turf/simulated/floor/tiled)
"aB" = (/mob/living/simple_animal/hostile/mining_borg/behemoth,/turf/simulated/floor/tiled)
"aC" = (/obj/effect/floor_decal/plaque,/turf/simulated/floor/tiled)
"aD" = (/obj/random/loot,/obj/effect/decal/cleanable/dirt,/turf/simulated/floor/tiled)
"aE" = (/obj/structure/table/steel_reinforced,/obj/item/storage/box/survival,/turf/simulated/floor/tiled)
"aF" = (/obj/structure/table/steel_reinforced,/obj/random/tool,/turf/simulated/floor/tiled)
"aH" = (/obj/structure/table/steel_reinforced,/obj/item/storage/box/trackimp,/turf/simulated/floor/tiled)
"aI" = (/obj/structure/table/standard,/turf/simulated/floor/tiled)
"aJ" = (/obj/item/modular_computer/console,/turf/simulated/floor/tiled)
"aK" = (/obj/structure/bed/chair/comfy/captain{color = "#666666"; dir = 8},/turf/simulated/floor/tiled)
"aL" = (/obj/structure/table/steel_reinforced,/obj/item/device/flashlight/lamp,/turf/simulated/floor/tiled)
"aM" = (/obj/structure/table/rack,/obj/item/device/flashlight/flare,/obj/item/device/flashlight/flare,/obj/item/device/flashlight/flare,/obj/item/device/flashlight/flare,/turf/simulated/floor/tiled/dark)
"aN" = (/obj/structure/bed/chair{icon_state = "chair_preview"; dir = 8},/turf/simulated/floor/tiled)
"aO" = (/obj/machinery/light{dir = 8; icon_state = "tube1"; pixel_y = 0},/turf/simulated/floor/tiled)
"aQ" = (/obj/structure/table/steel_reinforced,/obj/item/storage/box/PDAs,/obj/machinery/atmospherics/unary/vent_pump/on,/turf/simulated/floor/tiled)
"aR" = (/obj/structure/table/steel_reinforced,/obj/machinery/alarm{alarm_id = "xenobio3_alarm"; dir = 8; icon_state = "alarm0"; pixel_x = 24},/obj/item/storage/toolbox/emergency,/turf/simulated/floor/tiled)
"aT" = (/obj/machinery/light{icon_state = "tube1"; dir = 4},/turf/simulated/floor/tiled)
"aU" = (/obj/structure/table/rack,/obj/item/airlock_brace,/obj/item/airlock_brace,/obj/item/airlock_brace,/obj/item/crowbar/brace_jack,/turf/simulated/floor/tiled/dark)
"aV" = (/obj/structure/window/reinforced{dir = 4},/obj/machinery/telecomms/server,/turf/simulated/floor/bluegrid)
"aW" = (/obj/machinery/atmospherics/pipe/simple/hidden/supply{dir = 6},/obj/machinery/atmospherics/pipe/simple/hidden/scrubbers{dir = 6},/turf/simulated/floor/tiled)
"aX" = (/obj/machinery/atmospherics/pipe/simple/hidden/supply{dir = 4},/obj/machinery/atmospherics/pipe/simple/hidden/scrubbers{dir = 4},/turf/simulated/floor/tiled)
"aY" = (/obj/machinery/door/airlock,/obj/machinery/door/firedoor,/obj/machinery/atmospherics/pipe/simple/hidden/supply{dir = 4},/obj/machinery/atmospherics/pipe/simple/hidden/scrubbers{dir = 4},/turf/simulated/floor/tiled)
"aZ" = (/obj/machinery/atmospherics/pipe/simple/hidden/supply{dir = 9; pixel_y = 0},/obj/machinery/atmospherics/pipe/simple/hidden/scrubbers{dir = 4},/turf/simulated/floor/tiled)
"ba" = (/obj/machinery/light,/obj/machinery/atmospherics/unary/vent_scrubber/on{dir = 8},/turf/simulated/floor/tiled)
"bb" = (/obj/structure/filingcabinet,/turf/simulated/floor/tiled)
"bc" = (/obj/machinery/light,/turf/simulated/floor/tiled)
"bd" = (/obj/machinery/door/airlock,/obj/machinery/door/firedoor,/turf/simulated/floor/tiled)
"be" = (/obj/structure/table/rack,/obj/item/storage/box/teargas{pixel_x = 3; pixel_y = 2},/obj/item/storage/box/handcuffs,/obj/item/storage/box/flashbangs{pixel_x = -2; pixel_y = -2},/turf/simulated/floor/tiled/dark)
"bf" = (/obj/structure/table/rack,/turf/simulated/floor/plating)
"bg" = (/obj/machinery/telecomms/server/presets/common,/obj/effect/floor_decal/industrial/outline/grey,/turf/simulated/floor/bluegrid)
"bh" = (/obj/structure/window/reinforced{dir = 4},/turf/simulated/floor/bluegrid)
"bi" = (/obj/machinery/light{icon_state = "tube1"; dir = 4},/obj/machinery/atmospherics/unary/vent_pump/on,/turf/simulated/floor/tiled)
"bj" = (/obj/machinery/door/firedoor,/obj/machinery/atmospherics/pipe/simple/hidden/supply,/obj/machinery/atmospherics/pipe/simple/hidden/scrubbers,/turf/simulated/floor/tiled)
"bk" = (/obj/machinery/door/firedoor,/turf/simulated/floor/tiled)
"bl" = (/obj/machinery/light/small{dir = 8},/turf/simulated/floor/plating)
"bm" = (/obj/structure/table/rack,/obj/item/melee/baton,/obj/item/melee/baton,/turf/simulated/floor/plating)
"bn" = (/obj/structure/table/rack,/obj/item/handcuffs,/turf/simulated/floor/plating)
"bo" = (/obj/machinery/telecomms/server,/turf/simulated/floor/bluegrid)
"bp" = (/turf/simulated/floor/bluegrid)
"bq" = (/obj/machinery/atmospherics/unary/vent_scrubber/on{dir = 4},/turf/simulated/floor/tiled)
"br" = (/obj/machinery/atmospherics/pipe/simple/hidden/supply{dir = 5},/obj/machinery/atmospherics/pipe/simple/hidden/scrubbers{dir = 4},/turf/simulated/floor/tiled)
"bs" = (/obj/machinery/door/airlock,/obj/machinery/atmospherics/pipe/simple/hidden/supply{dir = 4},/obj/machinery/atmospherics/pipe/simple/hidden/scrubbers{dir = 4},/turf/simulated/floor/tiled)
"bt" = (/obj/machinery/atmospherics/pipe/manifold4w/hidden/supply,/obj/machinery/atmospherics/pipe/manifold4w/hidden/scrubbers,/turf/simulated/floor/tiled)
"bu" = (/obj/machinery/atmospherics/pipe/simple/hidden/supply{dir = 10},/obj/machinery/atmospherics/pipe/simple/hidden/scrubbers{dir = 4},/turf/simulated/floor/tiled)
"bv" = (/obj/machinery/atmospherics/unary/vent_scrubber/on{dir = 8},/turf/simulated/floor/tiled)
"bw" = (/obj/machinery/light{dir = 1},/turf/simulated/floor/tiled)
"bx" = (/obj/machinery/papershredder,/turf/simulated/floor/tiled)
"by" = (/obj/machinery/photocopier,/turf/simulated/floor/tiled)
"bz" = (/obj/structure/filingcabinet,/obj/machinery/atmospherics/unary/vent_scrubber/on,/turf/simulated/floor/tiled)
"bA" = (/obj/machinery/door/firedoor,/obj/structure/grille,/obj/machinery/door/firedoor,/obj/structure/window_frame,/turf/simulated/floor/tiled)
"bB" = (/obj/effect/decal/cleanable/dirt,/obj/machinery/atmospherics/pipe/simple/hidden/supply,/obj/machinery/atmospherics/pipe/simple/hidden/scrubbers,/turf/simulated/floor/tiled)
"bC" = (/obj/structure/closet,/obj/item/reagent_containers/food/drinks/bottle/tequilla,/obj/item/reagent_containers/food/drinks/bottle/wine,/obj/machinery/atmospherics/unary/vent_pump/on{dir = 1; layer = 2.4; level = 2},/turf/simulated/floor/tiled)
"bD" = (/obj/structure/table/woodentable,/obj/random/loot,/turf/simulated/floor/tiled,/area/template_noop)
"bE" = (/obj/structure/bed/chair/comfy/brown{dir = 4},/turf/simulated/floor/tiled)
"bF" = (/obj/structure/table/woodentable,/obj/random/loot,/turf/simulated/floor/tiled)
"bH" = (/obj/structure/bed/chair/comfy/brown{dir = 8},/turf/simulated/floor/tiled)
"bI" = (/obj/machinery/atmospherics/pipe/simple/hidden/scrubbers,/turf/simulated/floor/tiled)
"bJ" = (/obj/structure/table/steel_reinforced,/turf/simulated/floor/plating)
"bK" = (/obj/machinery/suit_storage_unit/security/alt,/turf/simulated/floor/plating,/area/template_noop)
"bL" = (/obj/structure/table/steel_reinforced,/obj/item/handcuffs,/turf/simulated/floor/plating)
"bM" = (/obj/structure/table/steel_reinforced,/obj/item/material/harpoon,/turf/simulated/floor/plating)
"bN" = (/obj/structure/grille,/obj/machinery/door/firedoor,/obj/structure/window_frame,/turf/simulated/floor/tiled)
"bO" = (/obj/structure/table/steel,/obj/random/tool,/obj/random/tool,/obj/random/tool,/turf/simulated/floor/tiled)
"bP" = (/obj/item/modular_computer/console,/obj/effect/decal/cleanable/blood,/turf/simulated/floor/tiled)
"bQ" = (/obj/structure/closet,/obj/item/storage/backpack/industrial,/obj/item/storage/toolbox/electrical,/turf/simulated/floor/tiled)
"bR" = (/obj/structure/closet,/obj/item/clothing/suit/space/emergency,/turf/simulated/floor/tiled)
"bS" = (/obj/structure/closet,/obj/item/storage/backpack/industrial,/obj/item/storage/toolbox/mechanical,/obj/machinery/atmospherics/unary/vent_scrubber/on,/turf/simulated/floor/tiled)
"bT" = (/obj/structure/closet,/obj/item/clothing/suit/radiation,/obj/item/clothing/suit/radiation,/obj/machinery/atmospherics/unary/vent_pump/on,/turf/simulated/floor/tiled)
"bU" = (/turf/simulated/wall)
"bV" = (/obj/machinery/atmospherics/pipe/simple/hidden/supply,/obj/machinery/atmospherics/pipe/simple/hidden/scrubbers,/turf/simulated/floor/tiled)
"bW" = (/obj/structure/closet,/obj/item/reagent_containers/food/drinks/flask/shiny,/turf/simulated/floor/tiled)
"bX" = (/obj/structure/bed/chair/comfy/brown,/turf/simulated/floor/tiled)
"bY" = (/obj/machinery/atmospherics/pipe/simple/hidden/supply{dir = 6},/obj/machinery/atmospherics/pipe/simple/hidden/scrubbers{dir = 5},/turf/simulated/floor/tiled)
"bZ" = (/obj/effect/decal/cleanable/dirt,/obj/machinery/atmospherics/pipe/simple/hidden/supply{dir = 10},/obj/machinery/atmospherics/pipe/simple/hidden/scrubbers{dir = 10},/turf/simulated/floor/tiled)
"ca" = (/obj/machinery/door/airlock,/obj/machinery/door/firedoor,/turf/simulated/floor/plating)
"cb" = (/obj/structure/table/steel,/turf/simulated/floor/tiled)
"cc" = (/obj/structure/bed/chair{icon_state = "chair_preview"; dir = 8},/obj/effect/landmark/corpse/engineer,/obj/effect/decal/cleanable/blood,/turf/simulated/floor/tiled)
"cd" = (/obj/machinery/atmospherics/pipe/simple/hidden/scrubbers{dir = 5},/turf/simulated/floor/tiled)
"ce" = (/obj/random/trash,/obj/machinery/atmospherics/pipe/simple/hidden/supply{dir = 5},/obj/machinery/atmospherics/pipe/simple/hidden/scrubbers{dir = 4},/turf/simulated/floor/tiled)
"cf" = (/obj/machinery/atmospherics/pipe/manifold4w/hidden/supply,/obj/machinery/atmospherics/pipe/manifold/hidden/scrubbers{dir = 4},/turf/simulated/floor/tiled)
"cg" = (/obj/effect/decal/cleanable/dirt,/obj/machinery/atmospherics/unary/vent_pump/on{dir = 8},/turf/simulated/floor/tiled)
"ch" = (/obj/structure/closet,/obj/item/reagent_containers/food/drinks/golden_cup,/turf/simulated/floor/tiled)
"ci" = (/obj/structure/table/woodentable,/obj/item/storage/backpack/captain,/obj/machinery/alarm{alarm_id = "xenobio3_alarm"; dir = 8; icon_state = "alarm0"; pixel_x = 24},/turf/simulated/floor/tiled)
"cj" = (/obj/structure/table/woodentable,/obj/item/folder/blue,/turf/simulated/floor/tiled)
"ck" = (/obj/machinery/alarm{alarm_id = "xenobio3_alarm"; dir = 8; icon_state = "alarm0"; pixel_x = 24},/obj/machinery/atmospherics/pipe/simple/hidden/supply,/turf/simulated/floor/tiled)
"cl" = (/obj/machinery/atmospherics/unary/vent_pump/on{dir = 4},/turf/simulated/floor/tiled)
"cm" = (/obj/effect/decal/cleanable/dirt,/obj/machinery/atmospherics/pipe/manifold4w/hidden/supply,/obj/machinery/atmospherics/pipe/manifold/hidden/scrubbers{dir = 8},/turf/simulated/floor/tiled)
"cn" = (/obj/machinery/atmospherics/pipe/simple/hidden/supply{dir = 4},/obj/machinery/atmospherics/pipe/simple/hidden/scrubbers{dir = 10},/turf/simulated/floor/tiled)
"co" = (/obj/machinery/light{dir = 1},/obj/machinery/atmospherics/pipe/simple/hidden/supply{dir = 4},/turf/simulated/floor/tiled)
"cp" = (/obj/machinery/atmospherics/pipe/manifold/hidden/supply{dir = 1},/obj/random/mining_hostile,/turf/simulated/floor/tiled)
"cq" = (/obj/random/mining_hostile,/turf/simulated/floor/tiled)
"cr" = (/obj/structure/table/steel_reinforced,/obj/machinery/atmospherics/unary/vent_pump/on{dir = 8},/turf/simulated/floor/tiled)
"cs" = (/obj/structure/table/steel,/obj/random/tank,/turf/simulated/floor/tiled)
"ct" = (/obj/machinery/alarm{alarm_id = "xenobio3_alarm"; dir = 8; icon_state = "alarm0"; pixel_x = 24},/turf/simulated/floor/tiled)
"cu" = (/obj/machinery/atmospherics/pipe/simple/hidden/supply,/obj/machinery/atmospherics/pipe/manifold/hidden/scrubbers{dir = 8},/turf/simulated/floor/tiled)
"cv" = (/obj/structure/bed,/obj/item/bedsheet/captain,/turf/simulated/floor/tiled)
"cw" = (/obj/structure/table/woodentable,/obj/item/reagent_containers/food/drinks/bottle/whiskey,/turf/simulated/floor/tiled)
"cx" = (/turf/simulated/floor/tiled)
"cz" = (/obj/structure/table/woodentable,/turf/simulated/floor/tiled)
"cA" = (/obj/structure/table/woodentable,/obj/random/action_figure,/obj/machinery/atmospherics/unary/vent_pump/on{dir = 1},/turf/simulated/floor/tiled)
"cB" = (/obj/effect/decal/cleanable/dirt,/obj/effect/decal/cleanable/dirt,/obj/machinery/atmospherics/pipe/simple/hidden/supply,/obj/machinery/atmospherics/pipe/simple/hidden/scrubbers,/turf/simulated/floor/tiled)
"cC" = (/obj/item/stool,/obj/machinery/atmospherics/pipe/simple/hidden/scrubbers{dir = 5},/turf/simulated/floor/tiled)
"cD" = (/obj/item/stool,/obj/machinery/atmospherics/pipe/simple/hidden/scrubbers{dir = 4},/turf/simulated/floor/tiled)
"cE" = (/obj/machinery/atmospherics/pipe/simple/hidden/supply,/obj/machinery/atmospherics/pipe/manifold/hidden/scrubbers{dir = 1},/turf/simulated/floor/tiled)
"cF" = (/obj/structure/table/steel_reinforced,/obj/machinery/atmospherics/unary/vent_scrubber/on{dir = 8},/turf/simulated/floor/tiled)
"cG" = (/obj/machinery/alarm{dir = 1; pixel_y = -25; req_one_access = list(24,11)},/turf/simulated/floor/tiled)
"cH" = (/obj/structure/closet,/obj/item/reagent_containers/spray/pepper,/obj/item/storage/box/handcuffs,/obj/machinery/atmospherics/unary/vent_pump/on{dir = 1},/turf/simulated/floor/tiled)
"cI" = (/obj/structure/table/rack,/obj/random/tool,/turf/simulated/floor/tiled)
"cJ" = (/obj/machinery/light{dir = 8; icon_state = "tube1"; pixel_y = 0},/obj/machinery/atmospherics/pipe/simple/hidden/supply,/obj/machinery/atmospherics/pipe/simple/hidden/scrubbers,/turf/simulated/floor/tiled)
"cK" = (/obj/machinery/light{icon_state = "tube1"; dir = 4},/obj/machinery/atmospherics/pipe/simple/hidden/supply,/obj/machinery/atmospherics/pipe/simple/hidden/scrubbers,/turf/simulated/floor/tiled)
"cL" = (/obj/structure/lattice,/turf/template_noop,/area/template_noop)
"cM" = (/obj/machinery/door/airlock,/obj/machinery/atmospherics/pipe/simple/hidden/supply,/obj/machinery/atmospherics/pipe/simple/hidden/scrubbers,/turf/simulated/floor/tiled)
"cN" = (/obj/machinery/door/airlock,/turf/simulated/floor/tiled)
"cO" = (/obj/structure/table/steel_reinforced,/obj/item/storage/box/fingerprints,/turf/simulated/floor/tiled)
"cP" = (/obj/effect/decal/cleanable/dirt,/obj/random/mining_hostile,/turf/simulated/floor/tiled)
"cQ" = (/obj/structure/table/rack,/obj/random/tech_supply,/turf/simulated/floor/tiled)
"cR" = (/obj/machinery/atmospherics/pipe/manifold/hidden/supply{dir = 8},/obj/machinery/atmospherics/pipe/manifold/hidden/scrubbers{dir = 8},/turf/simulated/floor/tiled)
"cS" = (/obj/machinery/alarm{alarm_id = "xenobio4_alarm"; dir = 2; icon_state = "alarm0"; pixel_x = 0; pixel_y = 24},/obj/machinery/atmospherics/pipe/manifold/hidden/supply{dir = 1},/obj/machinery/atmospherics/pipe/simple/hidden/scrubbers{dir = 10},/obj/effect/decal/cleanable/blood,/turf/simulated/floor/tiled)
"cT" = (/obj/item/modular_computer/console,/obj/machinery/light{dir = 1},/obj/machinery/atmospherics/unary/vent_pump/on{dir = 8},/obj/effect/decal/cleanable/blood,/turf/simulated/floor/tiled)
"cU" = (/obj/structure/table/woodentable,/obj/item/disk/secret_project/science,/turf/simulated/floor/tiled)
"cV" = (/obj/structure/grille,/obj/machinery/door/firedoor,/obj/structure/window_frame{icon_state = "window1"; dir = 4},/turf/simulated/floor/tiled)
"cW" = (/obj/machinery/light{dir = 1},/obj/structure/table/standard,/obj/structure/window/reinforced{dir = 8},/obj/item/stack/material/phoron,/obj/item/stack/material/phoron,/obj/item/stack/material/phoron,/obj/item/stack/material/phoron,/obj/item/stack/material/phoron,/turf/simulated/floor/tiled)
"cX" = (/obj/structure/table/standard,/obj/machinery/reagentgrinder,/turf/simulated/floor/tiled)
"cY" = (/obj/machinery/light{dir = 1},/obj/structure/table/standard,/obj/item/storage/box/monkeycubes,/turf/simulated/floor/tiled)
"cZ" = (/obj/structure/table/standard,/obj/item/storage/box/beakers,/turf/simulated/floor/tiled)
"da" = (/obj/machinery/alarm{alarm_id = "xenobio3_alarm"; dir = 8; icon_state = "alarm0"; pixel_x = 24},/obj/machinery/atmospherics/pipe/simple/hidden/supply,/obj/machinery/atmospherics/pipe/simple/hidden/scrubbers,/turf/simulated/floor/tiled)
"db" = (/obj/structure/bed,/turf/simulated/floor/tiled)
"dc" = (/obj/machinery/atmospherics/pipe/manifold/hidden/supply{dir = 8},/obj/machinery/atmospherics/pipe/manifold/hidden/scrubbers,/turf/simulated/floor/tiled)
"dd" = (/obj/machinery/door/airlock,/obj/machinery/atmospherics/pipe/simple/hidden/supply{dir = 4},/turf/simulated/floor/tiled)
"de" = (/obj/machinery/atmospherics/pipe/manifold/hidden/supply{dir = 1},/obj/machinery/atmospherics/pipe/simple/hidden/scrubbers{dir = 4},/turf/simulated/floor/tiled)
"df" = (/obj/machinery/atmospherics/pipe/simple/hidden/supply{dir = 4},/obj/machinery/atmospherics/pipe/manifold/hidden/scrubbers{dir = 1},/turf/simulated/floor/tiled)
"dg" = (/obj/machinery/atmospherics/pipe/simple/hidden/supply{dir = 10},/obj/machinery/atmospherics/pipe/simple/hidden/scrubbers{dir = 10},/turf/simulated/floor/tiled)
"dh" = (/obj/structure/reagent_dispensers/fueltank,/turf/simulated/floor/tiled)
"di" = (/obj/structure/sign/science_2{pixel_x = 30},/turf/simulated/floor/tiled)
"dj" = (/obj/structure/bed/chair/comfy/brown{dir = 4},/obj/effect/landmark/corpse/scientist,/obj/effect/decal/cleanable/blood,/turf/simulated/floor/tiled)
"dk" = (/obj/structure/grille,/obj/machinery/door/firedoor,/obj/structure/window_frame{icon_state = "window1"; dir = 1},/turf/simulated/floor/tiled)
"dl" = (/obj/machinery/door/window/eastleft,/obj/machinery/door/firedoor,/turf/simulated/floor/tiled)
"dm" = (/obj/machinery/atmospherics/unary/vent_pump/on{dir = 1},/obj/machinery/alarm{alarm_id = "xenobio3_alarm"; dir = 8; icon_state = "alarm0"; pixel_x = 24},/turf/simulated/floor/tiled)
"do" = (/obj/machinery/atmospherics/unary/vent_scrubber/on{dir = 1},/turf/simulated/floor/tiled)
"dp" = (/obj/structure/table/rack,/obj/random/tool,/obj/random/powercell,/turf/simulated/floor/tiled)
"dq" = (/obj/item/modular_computer/console,/obj/machinery/atmospherics/unary/vent_scrubber/on{dir = 8},/turf/simulated/floor/tiled)
"dr" = (/obj/structure/table/woodentable,/obj/item/device/flashlight/lamp,/turf/simulated/floor/tiled)
"ds" = (/obj/structure/grille,/obj/machinery/door/firedoor,/obj/structure/window_frame{icon_state = "window1"; dir = 8},/turf/simulated/floor/tiled)
"du" = (/obj/machinery/door/airlock,/obj/machinery/door/firedoor,/obj/machinery/atmospherics/pipe/simple/hidden/supply,/obj/machinery/atmospherics/pipe/simple/hidden/scrubbers,/turf/simulated/floor/tiled)
"dv" = (/obj/random/loot,/turf/simulated/floor/tiled)
"dw" = (/obj/structure/bed/chair,/turf/simulated/floor/tiled)
"dx" = (/obj/structure/bed,/obj/item/trash/snack_bowl,/turf/simulated/floor/tiled)
"dy" = (/obj/machinery/light{icon_state = "tube1"; dir = 4},/obj/effect/decal/cleanable/dirt,/turf/simulated/floor/tiled)
"dz" = (/obj/machinery/light{dir = 8; icon_state = "tube1"; pixel_y = 0},/obj/structure/table/steel_reinforced,/obj/item/storage/box/flashshells,/turf/simulated/floor/tiled)
"dA" = (/obj/machinery/atmospherics/pipe/simple/hidden/supply{dir = 5},/obj/machinery/atmospherics/pipe/simple/hidden/scrubbers,/turf/simulated/floor/tiled)
"dB" = (/obj/machinery/atmospherics/pipe/simple/hidden/supply{dir = 4},/turf/simulated/floor/tiled)
"dC" = (/obj/structure/closet,/obj/item/clothing/suit/storage/toggle/labcoat/blue,/obj/machinery/atmospherics/unary/vent_pump/on{dir = 8},/turf/simulated/floor/tiled)
"dD" = (/obj/structure/closet,/obj/item/clothing/suit/storage/toggle/labcoat/blue,/obj/item/disk/survey,/turf/simulated/floor/tiled)
"dF" = (/obj/structure/table/standard,/obj/item/device/flashlight/lamp,/turf/simulated/floor/tiled)
"dG" = (/obj/structure/table/steel_reinforced,/obj/item/reagent_containers/spray/pepper,/turf/simulated/floor/tiled)
"dH" = (/obj/item/modular_computer/console,/obj/machinery/alarm{dir = 1; pixel_y = -25; req_one_access = list(24,11)},/turf/simulated/floor/tiled)
"dI" = (/obj/effect/decal/cleanable/dirt,/obj/random/trash,/obj/machinery/atmospherics/pipe/simple/hidden/supply,/obj/machinery/atmospherics/pipe/simple/hidden/scrubbers,/turf/simulated/floor/tiled)
"dJ" = (/obj/item/modular_computer/console,/obj/machinery/light{dir = 8; icon_state = "tube1"; pixel_y = 0},/obj/machinery/atmospherics/unary/vent_scrubber/on{dir = 1},/turf/simulated/floor/tiled)
"dK" = (/obj/machinery/r_n_d/destructive_analyzer,/turf/simulated/floor/tiled)
"dL" = (/obj/random/trash,/turf/simulated/floor/plating)
"dM" = (/turf/simulated/floor/airless{icon_state = "dmg2"})
"dN" = (/obj/structure/bed,/obj/machinery/atmospherics/unary/vent_pump/on{dir = 4},/turf/simulated/floor/tiled)
"dO" = (/obj/machinery/atmospherics/pipe/simple/hidden/supply{dir = 9; pixel_y = 0},/obj/machinery/atmospherics/pipe/simple/hidden/scrubbers,/turf/simulated/floor/tiled)
"dP" = (/obj/effect/decal/cleanable/dirt,/obj/machinery/atmospherics/unary/vent_scrubber/on{dir = 1},/turf/simulated/floor/tiled)

(1,1,1) = {"
aaaaaaaaaaaaaaaaaaaaaaaaaaaaaaaaaaaaaaaaaaaaaaaaaaaaaaaaaaaaaaaaaaaaaaaaaaab
aaaaaaaaaaaaaaaaaaaaaaaaaaaaaaaaacaaaaaaafaaaaaaaaaaaaaaaaaaaaaaaaaaaaaaabab
abaaaaaaaaaaaaaaaaaaaaaaaaaaaaagafafaaaaagafaaaaaaaaaaaaaaaaaaaaaaaaaaababab
aaaaaaaaaaaaaaaaaaaaaaaaaaaaafafahaJafafcxcxaeaaaaaaaaaaaaaaaaaaaaaaabababab
ababaaaaaaaaaaaaaaaaaaaaaaagcxcxahcxakcxcxamahanalabababaaaaaaaaaaababababab
abababababaaaaaaaaaaaaaaalaoapapahahcxcxcxcxcxaqalababababaaaaaaabababababab
abababababababaaaaaaalararasatahavcxcxcxahcxcxawararalababababababababababab
abababababababababaaalaJapapahcxahcxcxcxcxcxaxcxcxaJalababababababababababab
ababababababababababauaJaycxahcxadcxahcxaBaxcxcxazaJauababababababababababab
ababababababababababalaJcxahcxcxcxcxcxcxahcxcxcxcxaJalababababababababababab
ababababababababalalalaraAcxcxcxcxcxaCcxahaDcxcxaEaralalalababababababababab
abababababalalalalbDbDalaFaxcxahcxaJaJaJcxahcxcxaHarbDbDalalalalabababababab
abababababalaIaJarcxcxaraFcxcxcxcxcxaKcxcxcxcxcxaLarcxcxaraMafalabababababab
ababababalalaIaNaraOcxaraQcxcxcxcxcxcxcxcxcxcxcxaRarcxaTaraUafalalababababab
abababalalaVcxcxaraWaXaYaZbacxbbbbbbcxbbbbbbbbbccxbdcxcxarbeafbfalalabababab
ababalalbgbhcxbiarbjbkarararbdarararbdarararararararbkbkarblafbmbnalalababab
abalalbobpbpbqbrbsbtaXaYbubvcxarcxcxcxcxbwcxbxbybzbAcxcxarafafafafafalalabab
arararararararararbBcxarbCcxbbarcxbEbFczbHcxcxcxbIarcxaharafbJbLbMafbKalalab
bNbOaJbPbQbRbSbTbUbVcxarbWcxbXarcxbEczczbHcxcxaxbYbsaXbZarcaarararararararar
arcbccapcxcxcdcebscfcgarchcxciarcxbEczcjbHcxcxcxckarclcmaYcncodBcpcraNbwbbar
arcscxcxcqcxcxctbUcubvarcvbccwarcxcxcxcxbccxbFczcAbAaxcBarcCcDcDcEcFaJcGcxar
arcxcxafafafcxcIbUcJaxarararararararararararararararcxcKararararcMarararcNar
arcxcxafcLabafcQbUcRaXaYcScTcUcVaIcWcXaIcYcZaIbxbyarcxdaardbbNbqdcdddedfdgar
ardhcxafababafcQbUbVdiarbVdjczdkcxcxcxcxcxcxcxcxctarcxbVarcxdlcxdmarcHdobBcV
afdhcxafabcLafdpbUbBcxarcudqdrdscxcxcxaBahahcxcxbbarahbVarararahcxarcOcxbVdk
afcxcxafcLabafcxbUbVcxarduarararcxdvcxdwcxcxdwcxbbarahbVardxbNahdyardzdwbVds
afafaxafabafafcxbUbVcxardAdBdCdDcxcxaIaJdFaIaJaIbbarahbVarahdlcxahardGdHbVar
afafcxafafafcxcxbUdIcxardJcxcxcxcxafafafafafafafafafcxcKarararcxaharararcMar
afafafcxcxaxcxafbUbVcxardKahcxcxdLafababcLabafafdMafcxbVarcxbNcxcPardbdNdOcV
afafafcxcxcxcxafbUbjbkarcxahafafdMafcLabcLabdLafafafbkbjafcxdlcxcxarcxcxdPdk
afcLafafaxcxcxafbUbVcxafcxcxafafafafcLcLcLcLcLafafafafdMafafafcxcxcNcxafafds
cLcLafafcxcxafafbUbVaxafafafdLababcLcLcLabcLabdMafababcLababdMafcxararafafaf
abcLafafafafafafbUbVcxafdMafafababcLcLcLabcLabababababcLcLabafdLafarafafdMab
abcLabdMafdLafafbUabafafafcLcLababcLababababababababababcLababafafafafafafab
abababafafafafafbUcLcLcLabcLcLcLabababababababababababababababababafafdMabab
ababcLafafdMafdMababcLcLababcLababababababababababababababababababcLabababab
ababcLcLababafcLcLabcLabababcLababababababababababababababababababcLabababab
abababcLcLababcLabababababababababababababababababababababababababababababab
abababcLabababababababababababababababababababababababababababababababababab
"}
