"a" = (/turf/simulated/floor/dirty/indestructable,/area/space)
"b" = (/obj/effect/landmark/start{name = "Blue Soldier"},/turf/simulated/floor/dirty/indestructable,/area/space)
"c" = (/obj/structure/dirt_wall,/turf/simulated/floor/dirty/indestructable,/area/space)
"d" = (/obj/machinery/telecomms/allinone{intercept = 1},/turf/simulated/floor/dirty,/area/hallway)
"e" = (/obj/structure/barbwire,/turf/simulated/floor/dirty/indestructable,/area/space)
"f" = (/obj/structure/dirt_wall{icon_state = "dirt_wall"; dir = 1},/turf/simulated/floor/dirty/indestructable,/area/space)
"g" = (/obj/structure/dirt_wall{icon_state = "dirt_wall"; dir = 8},/turf/simulated/floor/dirty/indestructable,/area/space)
"h" = (/turf/simulated/wall/concrete,/area/space)
"i" = (/obj/structure/dirt_wall{icon_state = "dirt_wall"; dir = 4},/turf/simulated/floor/dirty/indestructable,/area/space)
"j" = (/obj/effect/landmark/start{name = "Red Soldier"},/turf/simulated/floor/dirty/indestructable,/area/space)
"k" = (/obj/effect/landmark{name = "tdome1"},/turf/simulated/floor/dirty/indestructable,/area/space)
"l" = (/obj/effect/landmark{name = "JoinLate"},/turf/simulated/floor/dirty/indestructable,/area/space)
"m" = (/obj/effect/landmark/test/safe_turf,/turf/simulated/floor/dirty/indestructable,/area/space)
"n" = (/obj/effect/landmark/test/space_turf,/turf/simulated/floor/dirty/indestructable,/area/space)
"o" = (/obj/effect/landmark/start,/turf/simulated/floor/dirty/indestructable,/area/space)

(1,1,1) = {"
aaaaaaaaaaaaaaaaaaaaaaaaaaaaaaaaaaaaaaaaaa
aaaaaaaaaaaaaaaaaaaaaaaaaaaaaaaaaaaaaaaaaa
aaaaaaaaaaaaaaaaaaaaaaaaaaaaaaaaaaaaaaaaaa
aaaaaaaaaaaaaaaaaaaaaaaaaaaaaaaaaaaaaaaaaa
aaaaaaaaaaaaaaaaaaaaaaaaaaaaaaaaaaaaaaaaaa
aaaaaaaaaaaaaaaaaaaaaaaaaaaaaaaaaaaaaaaaaa
aaaaaaaaaaaaaaaaaaaaaaaaaaaaaaaaaaaaaaaaaa
aaaaaaaaaaaaaaaaaaaaaaaaaaaaaaaaaaaaaaaaaa
aaaaaaaaaaaaaaaaaaaaaaaaaaaaaaaaaaaaaaaaaa
aaaaaaaaaaaaaaaaaaaaaaaaaaaaaaaaaaaaaaaaaa
aaaaaaaaaaaaaaaaaaaaaaaaaaaaaaaaaaaaaaaaaa
aaaaaaaaaaaaaaaaaaaaaaaaaaaaaaaaaaaaaaaaaa
aaaaaaaaaaaaaaaaaaaaaaaaaaaaaaaaaaaaaaaaaa
aaaaaaaaaaaaaaaaaaaaaaaaaaaaaaaaaaaaaaaaaa
aaaaaaaaaaaaaaaaaaaaaaaaaaaaaaaaaaaaaaaaaa
aaaaaaaaaaaaaaaaaaaaaaaaaaaaaaaaaaaaaaaaaa
aaabbbbbbbbbbbbbbbbbbbbbbbbbbbbbbbbaaaaaaa
aaccccccccccccccccccaaccccccccccccccccccaa
eeeeeeeeeeeeeeeeeeeeaaeeeeeeeeeeeeeeeeeeee
aaaaaaaaaaaaaaaaaaaaaaaaaaaaaaaaaaaaaaaaaa
aaaaaaaaaaaaaaaaaaaaaaaaaaaaaaaaaaaaaaaaaa
aaaaaaaaaaaaaaaaaaaaaaaaaaaaaaaaaaaaaaaaaa
aaaaaaaaaaaaaaaaaaaaaaaaaaaaaaaaaaaaaaaaaa
aaaaaaaaaaaaaaaaaaaaaaaaaaaaaaaaaaaaaaaaaa
aaaaaaaaaaaaaaaaaaaaaaaaaaaaaaaaaaaaaaaaaa
aaaaaaaaaaaaaaaaaaaaaaaaaaaaaaaaaaaaaaaaaa
aaaaaaaaaaaaaaaaaaaaaaaaaaaaaaaaaaaaaaaaaa
aaaaaaaaaaaaaaaaaaaaaaaaaaaaaaaaaaaaaaaaaa
aaaaaaaaaaaaaaaaaaeeeeeeaaaaaaaaaaaaaaaaaa
aaaaaaaaaaaaaaaaaaffffffaaaaaaaaaaaaaaaaaa
aaaaaaaaaaaaaaaaaaaaaaaaaaaaaaaaaaaaaaaaaa
aaaaaaaaaaaaaaaegahhhhhhaieaaaaaaaaaaaaaaa
aaaaaaaaaaaaaaaegaaaaaaaaieaaaaaaaaaaaaaaa
aaaaaaaaaaaaaaaegaaaaaaaaieaaaaaaaaaaaaaaa
aaaaaaaaaaaaaaaegahaaaahaieaaaaaaaaaaaaaaa
aaaaaaaaaaaaaaaegahaaaahaieaaaaaaaaaaaaaaa
aaaaaaaaaaaaaaaegahaaaahaieaaaaaaaaaaaaaaa
aaaaaaaaaaaaaaaegahaaaahaieaaaaaaaaaaaaaaa
aaaaaaaaaaaaaaaegahaaaahaieaaaaaaaaaaaaaaa
aaaaaaaaaaaaaaaegahaaaahaieaaaaaaaaaaaaaaa
aaaaaaaaaaaaaaaegaaaaaaaaieaaaaaaaaaaaaaaa
aaaaaaaaaaaaaaaegaaaaaaaaieaaaaaaaaaaaaaaa
aaaaaaaaaaaaaaaegahhhhhhaieaaaaaaaaaaaaaaa
aaaaaaaaaaaaaaaaaaaaaaaaaaaaaaaaaaaaaaaaaa
aaaaaaaaaaaaaaaaaaccccccaaaaaaaaaaaaaaaaaa
aaaaaaaaaaaaaaaaaaeeeeeeaaaaaaaaaaaaaaaaaa
aaaaaaaaaaaaaaaaaaaaaaaaaaaaaaaaaaaaaaaaaa
aaaaaaaaaaaaaaaaaaaaaaaaaaaaaaaaaaaaaaaaaa
aaaaaaaaaaaaaaaaaaaaaaaaaaaaaaaaaaaaaaaaaa
aaaaaaaaaaaaaaaaaaaaaaaaaaaaaaaaaaaaaaaaaa
aaaaaaaaaaaaaaaaaaaaaaaaaaaaaaaaaaaaaaaaaa
aaaaaaaaaaaaaaaaaaaaaaaaaaaaaaaaaaaaaaaaaa
aaaaaaaaaaaaaaaaaaaaaaaaaaaaaaaaaaaaaaaaaa
aaaaaaaaaaaaaaaaaaaaaaaaaaaaaaaaaaaaaaaaaa
aaaaaaaaaaaaaaaaaaaaaaaaaaaaaaaaaaaaaaaaaa
aaaaaaaaaaaaaaaaaaaaaaaaaaaaaaaaaaaaaaaaaa
eeeeeeeeeeeeeeeeeeeeaaeeeeeeeeeeeeeeeeeeee
aaffffffffffffffffffaaffffffffffffffffffaa
aaaaajjjjjjjjjjjjjjjjjjjjjjjjjjjjjjjjaaaaa
aaaaaaaaaaaaaaaaaaaaaaaaaaaaaaaaaaaaaaaaaa
aaaaaaaaahhhhhhhhhhhaahhhhhhhhhhhaaaaaaaaa
aaaaaaaaahaaaaaaaaahaahaaaaaaaaahaaaaaaaaa
aaaaaaaaahaaaaaaaaahaahaaaaaaaaahaaaaaaaaa
aaaaaaaaahaaaaaaaaahaahaaaaaaaaahaaaaaaaaa
aaaaaaaaahaaaaaaaaahaahaaaaaaaaahaaaaaaaaa
aaaaaaaaahaaaaaaaaahaahaaaaaaaaahaaaaaaaaa
aaaaaaaaahaaaaaaaaahaahaaaaaaaaahaaaaaaaaa
aaaaaaaaahaaaaaaaaahaahaaaaaaaaahaaaaaaaaa
aaaaaaaaahaaaaaaaaahaahaaaaaaaaahaaaaaaaaa
aaaaaaaaahhhhhhhhhhhaahhhhhhhhhhhaaaaaaaaa
aaaaaaaaaaaaaaaaaaaaaaaaaaaaaaaaaaaaaaaaaa
aaaaaaaaaaaaaaaaaaaaaaaaaaaaaaaaaaaaaaaaaa
kkklllaaaaaaaaaaaaaaaaaaaaaaaaaaaaaaaaaaaa
kkklllaaaaaaaaaaaaaaaaaaaaaaaaaaaaaaaaaaaa
kkklllaamnaoaaaaaaaaaaaaaaaaaaaaaaaaaaaaad
"}
