"a" = (/turf/template_noop,/area/template_noop)
"b" = (/area/template_noop)
"c" = (/obj/structure/filingcabinet,/obj/effect/decal/cleanable/cobweb,/turf/simulated/floor/tiled/dark,/area/template_noop)
"d" = (/obj/structure/bookcase/manuals/xenoarchaeology,/turf/simulated/floor/tiled/dark,/area/template_noop)
"e" = (/obj/structure/closet/crate/freezer/rations,/obj/effect/decal/cleanable/cobweb2,/turf/simulated/floor/tiled/dark,/area/template_noop)
"f" = (/obj/random/trash,/obj/structure/inflatable/door,/turf/simulated/floor/tiled/dark,/area/template_noop)
"g" = (/obj/random/junk,/obj/random/loot,/turf/simulated/floor/tiled/dark,/area/template_noop)
"h" = (/turf/simulated/floor/tiled/dark,/area/template_noop)
"i" = (/obj/structure/inflatable/door,/turf/simulated/floor/tiled/dark,/area/template_noop)
"j" = (/turf/simulated/floor/plating,/area/template_noop)
"k" = (/obj/structure/table/rack,/obj/item/clothing/glasses/eyepatch/hud/medical,/obj/random/loot,/obj/random/loot,/obj/random/hat,/obj/random/voidsuit,/turf/simulated/floor/tiled/dark,/area/template_noop)
"l" = (/obj/structure/sign/science_1{pixel_y = 32},/turf/simulated/floor/tiled/dark,/area/template_noop)
"m" = (/obj/machinery/artifact_scanpad,/turf/simulated/floor/tiled/dark,/area/template_noop)
"n" = (/obj/structure/gravemarker/random,/turf/template_noop,/area/template_noop)
"o" = (/obj/item/pen/multi,/turf/simulated/floor/tiled/dark,/area/template_noop)
"p" = (/obj/structure/bed/chair/wheelchair,/turf/simulated/floor/tiled/dark,/area/template_noop)
"q" = (/obj/structure/curtain/black,/turf/simulated/floor/carpet,/area/template_noop)
"r" = (/obj/machinery/r_n_d/server,/turf/simulated/floor/tiled/dark,/area/template_noop)
"s" = (/obj/structure/table/marble,/obj/item/device/flashlight/lamp,/obj/structure/sign/monkey_painting{pixel_y = -32},/turf/simulated/floor/tiled/dark,/area/template_noop)
"t" = (/obj/structure/table/marble,/obj/item/paper_bin,/obj/random/voidhelmet,/turf/simulated/floor/tiled/dark,/area/template_noop)
"u" = (/obj/structure/bed,/obj/item/bedsheet/rainbow,/obj/random/drinkbottle,/obj/random/trash,/turf/simulated/floor/carpet,/area/template_noop)
"J" = (/mob/living/bot/medbot,/turf/simulated/floor/tiled/dark,/area/template_noop)

(1,1,1) = {"
bbbbban
bcdebfb
bghhbib
jkhJlhb
bmopbqb
brstbub
bbbbbbb
"}
