"a" = (/turf/space,/area/space)
"c" = (/turf/unsimulated/wall)
"k" = (/turf/unsimulated/floor{icon_state = "hydrofloor"})

(1,1,1) = {"
aaaaaaaaaaaaaaaaaaaaaaaaaaaa
aaaaaaaaaaaaaaaaaaaaaaaaaaaa
aaaaaaaaaaaaaaaaaaaaaaaaaaaa
aaaaaaaaaaaaaaaaaaaaaaaaaaaa
aaaaaaaaaaaaaaaaaaaaaaaaaaaa
aaaaaaaaaaaaaaaaaaaaaaaaaaaa
aaaaaaaaaaaaaaaaaaaaaaaaaaaa
aaaaaaaccccccccccccccaaaaaaa
aaaaaaackkkckcckkkckcaaaaaaa
aaaaaaaccccccccccccccaaaaaaa
aaaaaaaccccccccccccccaaaaaaa
aaaaaaackkkckcckkkckcaaaaaaa
aaaaaaaccccccccccccccaaaaaaa
aaaaaaaaaaaaaaaaaaaaaaaaaaaa
aaaaaaaaaaaaaaaaaaaaaaaaaaaa
aaaaaaaaaaaaaaaaaaaaaaaaaaaa
aaaaaaaaaaaaaaaaaaaaaaaaaaaa
aaaaaaaaaaaaaaaaaaaaaaaaaaaa
aaaaaaaaaaaaaaaaaaaaaaaaaaaa
aaaaaaaaaaaaaaaaaaaaaaaaaaaa
"}
