"a" = (/turf/space,/area/space)
"b" = (/obj/structure/lattice,/turf/space,/area/space)
"c" = (/turf/simulated/wall/r_wall)
"d" = (/obj/effect/floor_decal/industrial/outline/grey,/obj/machinery/message_server,/turf/simulated/floor/tiled/dark)
"e" = (/obj/machinery/power/apc{dir = 1; name = "north bump"; pixel_x = 0; pixel_y = 24},/obj/structure/cable{icon_state = "0-4"; d2 = 4},/obj/effect/floor_decal/industrial/warning{dir = 10},/turf/simulated/floor/plating)
"f" = (/obj/structure/cable{d2 = 8; icon_state = "0-8"},/obj/effect/floor_decal/industrial/warning,/turf/simulated/floor/plating)
"g" = (/obj/machinery/power/terminal{tag = "icon-term (WEST)"; icon_state = "term"; dir = 8},/obj/structure/cable/yellow{d2 = 2; icon_state = "0-2"},/obj/effect/floor_decal/industrial/warning{icon_state = "warning"; dir = 6},/obj/machinery/alarm/server{pixel_y = 28},/turf/simulated/floor/plating)
"h" = (/obj/machinery/telecomms/server/presets/command,/obj/effect/floor_decal/industrial/outline/grey,/turf/simulated/floor/tiled/dark)
"i" = (/turf/simulated/floor/bluegrid)
"j" = (/obj/structure/cable/yellow{d1 = 1; d2 = 2; icon_state = "1-2"},/turf/simulated/floor/bluegrid)
"k" = (/obj/machinery/telecomms/processor/preset_two,/obj/effect/floor_decal/industrial/outline/grey,/turf/simulated/floor/tiled/dark)
"l" = (/obj/machinery/telecomms/bus/preset_two,/obj/effect/floor_decal/industrial/outline/grey,/turf/simulated/floor/tiled/dark)
"m" = (/obj/machinery/telecomms/relay/preset/telecomms,/obj/effect/floor_decal/industrial/outline/grey,/turf/simulated/floor/tiled/dark)
"n" = (/obj/machinery/telecomms/broadcaster/preset_right,/obj/effect/floor_decal/industrial/outline/grey,/turf/simulated/floor/tiled/dark)
"o" = (/obj/machinery/telecomms/relay/preset/station,/obj/effect/floor_decal/industrial/outline/grey,/turf/simulated/floor/tiled/dark)
"p" = (/obj/machinery/telecomms/bus/preset_four,/obj/effect/floor_decal/industrial/outline/grey,/turf/simulated/floor/tiled/dark)
"q" = (/obj/machinery/telecomms/processor/preset_four,/obj/effect/floor_decal/industrial/outline/grey,/turf/simulated/floor/tiled/dark)
"r" = (/obj/machinery/light{icon_state = "tube1"; dir = 8},/turf/simulated/floor/bluegrid)
"s" = (/obj/machinery/telecomms/hub/preset,/obj/effect/floor_decal/industrial/outline/grey,/turf/simulated/floor/tiled/dark)
"t" = (/obj/machinery/light{dir = 4; icon_state = "tube1"; tag = ""},/turf/simulated/floor/bluegrid)
"u" = (/obj/machinery/telecomms/bus/preset_one,/obj/effect/floor_decal/industrial/outline/grey,/turf/simulated/floor/tiled/dark)
"v" = (/obj/machinery/telecomms/processor/preset_one,/obj/effect/floor_decal/industrial/outline/grey,/turf/simulated/floor/tiled/dark)
"w" = (/obj/effect/floor_decal/industrial/outline/grey,/obj/machinery/ntnet_relay,/turf/simulated/floor/tiled/dark)
"x" = (/obj/machinery/telecomms/receiver/preset_right,/obj/effect/floor_decal/industrial/outline/grey,/turf/simulated/floor/tiled/dark)
"y" = (/obj/machinery/bluespacerelay,/obj/effect/floor_decal/industrial/outline/grey,/turf/simulated/floor/tiled/dark)
"z" = (/obj/machinery/telecomms/processor/preset_three,/obj/effect/floor_decal/industrial/outline/grey,/turf/simulated/floor/tiled/dark)
"A" = (/obj/machinery/telecomms/bus/preset_three,/obj/effect/floor_decal/industrial/outline/grey,/turf/simulated/floor/tiled/dark)
"B" = (/obj/machinery/access_button{command = "cycle_interior"; frequency = 1381; master_tag = "telecoms_airlock"; name = "interior access button"; pixel_x = -25; pixel_y = -25; req_access = list(null)},/turf/simulated/floor/bluegrid)
"C" = (/obj/machinery/telecomms/server/presets/supply,/obj/effect/floor_decal/industrial/outline/grey,/turf/simulated/floor/tiled/dark)
"D" = (/obj/effect/floor_decal/industrial/outline/grey,/obj/machinery/atmospherics/unary/vent_scrubber/on,/turf/simulated/floor/tiled/dark)
"E" = (/obj/effect/floor_decal/industrial/outline/grey,/obj/machinery/atmospherics/unary/vent_pump/on,/turf/simulated/floor/tiled/dark)
"F" = (/obj/structure/grille,/obj/effect/wingrille_spawn/reinforced,/turf/simulated/floor/plating)
"G" = (/obj/machinery/door/airlock/external{frequency = 1381; icon_state = "door_locked"; id_tag = "telecoms_inner"; locked = 1; name = "External Access"; req_access = list(null)},/turf/simulated/floor/plating)
"H" = (/obj/structure/grille,/obj/structure/cable/yellow{d1 = 1; d2 = 2; icon_state = "1-2"},/obj/effect/wingrille_spawn/reinforced,/turf/simulated/floor/plating)
"I" = (/obj/machinery/telecomms/server/presets/engineering,/obj/effect/floor_decal/industrial/outline/grey,/turf/simulated/floor/tiled/dark)
"J" = (/obj/machinery/telecomms/server/presets/service,/obj/effect/floor_decal/industrial/outline/grey,/obj/machinery/atmospherics/pipe/simple/hidden/scrubbers{dir = 5},/turf/simulated/floor/tiled/dark)
"K" = (/obj/machinery/telecomms/server/presets/medical,/obj/effect/floor_decal/industrial/outline/grey,/obj/machinery/atmospherics/pipe/simple/hidden/supply,/obj/machinery/atmospherics/pipe/simple/hidden/scrubbers{dir = 10},/turf/simulated/floor/tiled/dark)
"L" = (/obj/machinery/atmospherics/unary/vent_pump/high_volume{dir = 2; frequency = 1381; id_tag = "telecoms_pump"},/obj/machinery/embedded_controller/radio/airlock/airlock_controller{frequency = 1381; id_tag = "telecoms_airlock"; pixel_x = 25; pixel_y = 10; req_access = list(null); tag_airpump = "telecoms_pump"; tag_chamber_sensor = "telecoms_sensor"; tag_exterior_door = "telecoms_outer"; tag_interior_door = "telecoms_inner"},/obj/machinery/airlock_sensor{frequency = 1381; id_tag = "telecoms_sensor"; pixel_x = 25; pixel_y = 0},/turf/simulated/floor/plating)
"M" = (/obj/machinery/telecomms/server/presets/security,/obj/effect/floor_decal/industrial/outline/grey,/obj/machinery/atmospherics/pipe/simple/hidden/supply,/obj/machinery/atmospherics/pipe/simple/hidden/scrubbers{dir = 6},/turf/simulated/floor/tiled/dark)
"N" = (/obj/machinery/telecomms/server/presets/common,/obj/effect/floor_decal/industrial/outline/grey,/obj/machinery/atmospherics/pipe/simple/hidden/scrubbers{dir = 9},/turf/simulated/floor/tiled/dark)
"O" = (/turf/simulated/wall/r_wall,/area/space)
"Y" = (/obj/machinery/telecomms/allinone,/turf/simulated/floor/plating,/area/space)

(1,1,1) = {"
aaaaaaaaaaaaaaaaaaaaaaaaaaaaaaaaaaaaaaaaaaaaaaaa
aaaaaaaaaaaaaaaaaaaaaaaaaaaaaaaaaaaaaaaaaaaaaaaa
aaaaaaaaaaaaaaaaaaaaaaaaaaaaaaaaaaaaaaaaaaaaaaaa
aaaaaaaaaaaaaaaaaaaaaaaaaaaaaaaaaaaaaaaaaaaaaaaa
aaaaaaaaaaaaaaaaaaaaaaaaaaaaaaaaaaaaaaaaaaaaaaaa
aaaaaaaaaaaaaaaaaaaaaaaaaaaaaaaaaaaaaaaaaaaaaaaa
aaaaaaaaaaaaaaaaaaaaaaaaaaaaaaaaaaaaaaaaaaaaaaaa
aaaaaaaaaaaaaaaaaaaaaaaaaaaaaaaaaaaaaaaaaaaaaaaa
aaaaaaaaaaaaaaaaaaaaaaaaaaaaaaaaaaaaaaaaaaaaaaaa
aaaaaaaaaaaaaaaaaaaaaaaaaaaaaaaaaaaaaaaaaaaaaaaa
aaaaaaaaaaaaaaaaaaaaaaaaaaaaaaaaaaaaaaaaaaaaaaaa
aaaaaaaaaaaaaaaaaaaaaaaaaaaaaaaaaaaaaaaaaaaaaaaa
aaaaaaaaaaaaaaaaaaaaaaaaaaaaaaaaaaaaaaaaaaaaaaaa
aaaaaaaaaaaaaaaaaaaaaaaaaaaaaaaaaaaaaaaaaaaaaaaa
aaaaaaaaaaaaaaaaaaaaaaaaaaaaaaaaaaaaaaaaaaaaaaaa
aaaaaaaaaaaaaaaaaaaaaaaaaaaaaaaaaaaaaaaaaaaaaaaa
aaaaaaaaaaaaaaaaaaaaaaaaaaaaaaaaaaaaaaaaaaaaaaaa
aaaaaaaaaaaaaaaaaaaaaaaaaaaaaaaaaaaaaaaaaaaaaaaa
aaaaaaaaaaaaaaaaaaaaaaaaaaaaaaaaaaaaaaaaaaaaaaaa
aaaaaaaaaaaaaaaaaaaaaaaaaaaaaaaaaaaaaaaaaaaaaaaa
aaaaaaaaaaaaaaaaaaaaaaaaaaaaaaaaaaaaaaaaaaaaaaaa
aaaaOOOaaaaaaaaaaaaaaaaaaaaaaaaaaaaaaaaaaaaaaaaa
aaaaOYOaaaaaaaaaaaaaaaaaaaaaaaaaaaaaaaaaaaaaaaaa
bbcccccccbbaaaaaaaaaaaaaaaaaaaaaaaaaaaaaaaaaaaaa
cccdefghcccaaaaaaaaaaaaaaaaaaaaaaaaaaaaaaaaaaaaa
ciiiiijiiicaaaaaaaaaaaaaaaaaaaaaaaaaaaaaaaaaaaaa
cklminjopqcaaaaaaaaaaaaaaaaaaaaaaaaaaaaaaaaaaaaa
criiisjiitcaaaaaaaaaaaaaaaaaaaaaaaaaaaaaaaaaaaaa
cuvwixjyzAcaaaaaaaaaaaaaaaaaaaaaaaaaaaaaaaaaaaaa
ciiiiBjiiicaaaaaaaaaaaaaaaaaaaaaaaaaaaaaaaaaaaaa
cCDEFGHEDIcaaaaaaaaaaaaaaaaaaaaaaaaaaaaaaaaaaaaa
ccJKFLHMNccaaaaaaaaaaaaaaaaaaaaaaaaaaaaaaaaaaaaa
"}
