"a" = (/turf/simulated/mineral/random,/area/space)
"b" = (/turf/simulated/floor/stone,/area/space)
"c" = (/turf/simulated/wall/rust,/area/space)
"d" = (/turf/simulated/wall/concrete,/area/space)
"e" = (/obj/structure/torchwall{dir = 8; icon_state = "torchwall0"},/turf/simulated/floor/stone,/area/space)
"f" = (/obj/structure/torchwall{dir = 4; icon_state = "torchwall0"},/turf/simulated/floor/stone,/area/space)
"g" = (/obj/structure/barbwire,/turf/simulated/floor/stone,/area/space)
"h" = (/turf/simulated/floor/dirty/indestructable/mud,/area/space)
"i" = (/obj/structure/barricade,/turf/simulated/floor/stone,/area/space)
"j" = (/turf/simulated/floor/plating/n2floor,/area/space)
"k" = (/obj/structure/curtain,/turf/simulated/floor/tiled/airless,/area/space)
"l" = (/turf/simulated/floor/tiled/airless,/area/space)
"m" = (/obj/structure/table/rack,/turf/simulated/floor/tiled/airless,/area/space)
"n" = (/obj/structure/landmine,/turf/simulated/floor/stone,/area/space)
"o" = (/obj/structure/sewers/wallholebigbrk,/turf/simulated/floor/stone,/area/space)
"p" = (/obj/structure/rubble/war,/turf/simulated/floor/stone,/area/space)
"q" = (/turf/simulated/floor/dirty/indestructable,/area/space)
"r" = (/obj/structure/landmine,/turf/simulated/floor/tiled/airless,/area/space)
"s" = (/obj/structure/rubble/war,/turf/simulated/floor/dirty/indestructable/mud,/area/space)
"t" = (/obj/structure/sewers/wallholebig,/turf/simulated/floor/stone,/area/space)
"u" = (/obj/structure/statue/verina,/turf/simulated/mineral/random,/area/space)
"v" = (/obj/structure/sewers/pipe,/turf/simulated/wall/concrete,/area/space)
"w" = (/turf/simulated/floor/airless/lava,/area/space)
"x" = (/obj/structure/forge,/turf/simulated/floor/stone,/area/space)

(1,1,1) = {"
aaaaaaaaaaaaaaaaaaaaaaaaaaaaaaaaaaaaaaaaaaaaaaaaaaaaaaaaaaaaaaaaaaaaaaaaaaaaaaaaaaaaaaaaaaaaaaaaaaaaaaaaaaaaaaaaaaaaaaaaaaaaa
aaaaaaaaaaaaaaaaaaaaaaaaaaaaaaaaaaaaaaaaaaaaaaaaaaaaaaaaaaaaaaaaaaaaaaaaaaaaaaaaaaaaaaaaaaaaaaaaaaaaaaaaaaaaaaaaaaaaaaaaaaaaa
aaaabbbbbbbaaaaaaaaaaaaaaaaaaaaaaaaaaaaaaaaaaaaaaaaaaaaaaaaaaaaaaaaaaaaaaaaaaaaaaaaaaaaaaaaaaaaaaabaaaaaaabbbaaaaaaaaaaaaaaaa
aabbbbbbbbbbbbaaaaaaaaaaaaaaaaaaaaaaaaaaaaaaaabbbaaaaaaaaaaaaaaaaaaaaaaaaaaaaaaaaaaaaabaaaaaaaaabbbaaaaaabbaaaaaaabbbaaaaaaaa
aabbbbbbbbbbbbbbbbbbbaaaaaaaaaaaaaaaaaaaaaaaabbbbaaaaaaaaaaaaaaaaaaaaaaaabbbaaaaaaaabbbaaaaaaaaabaaaaaaaabbabbbbbbaabaaaaaaaa
aaabbbbbbbbbbaaaaaaabbbbaaaaaaaaaaaaaaaaaaabbbbbbbaaaaaaaaaaaaaaaaaaaaaaabbbaaaaaaabbaaaaaaaabbbbaaaaaaaaabbbaaaaaaaaaaaaaaaa
aaabbbbbbaabbaaaaaaaaabbbabbaaaaaaaaaaaabbbbbbbbbbaaaaaaaaaaaaaaaaaaabbbbbbbbbbbbbbbaaaaaaabbbbaaaaaaaaaaaaabbbbbaaaaaaaaaaaa
aaabbbbbaaaabaaaaaaaaabbbbbbbaaaaaaaaaabbaaabbbbbbaaaaaaaaaaaaaaaaabbbaabbbbaaaaaabbbbaaaabbaabbaaaaaaaaaaaaabbabaabbabbbbaaa
aaabbbbaaaabbaaaaaabbbbbbbbbbbbaaaabbbbbaaaabbbbbaaaaaaaaaaaabbbbbbbaaaaabbaaaaaaaaaabbaabbaaaabbbbaaaaaaaaaaabbbaaabbbaaaaaa
aaaabbbaaabbaaabbbbbbbbbbbbbbbbaaabbbbbaaaaaabbbbaaaaaaaaaaabbbbbbaaaaaaaaaaaaaaaaaaaabbbbaaaabbbbbaaaaaaaaaaabbbbbbbbbaaaaaa
aaaaaaaaabbaaabbaaaaabbbbbbbbbbbabbbbbbaaaaaaabbaaaaaaaaaaaabbbbbbbaaaaaaaaaaaaaaaaaaaabbaaaaabbbbbaaaabbbbaabbaaabbbbbaaaaaa
aaaaaaaaabaaabbaaaaaaaaaaaaaaaabbbbbbbbaaaaaaaabaaaaaaaaaaaabbbbbbaaaaaaaaaaaaabaaaaaaabbaaaaaabbaaabbbbaababbaaaabbbbbbaaaaa
aaaaaaaabbabbbaaaaaaaaaaaaaaaaaabbbbbbbaaaaaaaabaaaaaaaaaaaabbbbbbaaaaaabbbbbaabaaaaaaabbbaaaaaaaaabbaaaaabbaaaaaabbbbabbaaaa
aaaaaaabbbbbaaaaaabbbaaaaaaaaaaaabbbbbbaaaaaaaabbaaabbbbaaaaabbbbbabbbbbbbbbbbbbaaaaaabbabbbaaaaaaabaaaaaaabaaaaaaabbaaabaaaa
aaaaaaabbbbbaaaabbbbbaaaaaaaaaaaabbbbbaaaaaaaaaabbabbbbbaaaaabbbbaaaaabbbbbbbbbbbaaabbbaaaabbaaaabbbaaaaaaabaaaaaaabbaaabbaaa
aaaaaaabbbbaaaaabbbbbbaaaaaaaaaaaaaaaaaaaaaaaaaaaabbbbbbbbbbbbccaaaaaaaabbbaaabbbabbbaaaaaaabbbbbbbbbaaaaaabaaaaaaabaaaaabaaa
aaaaabbbbbbbbaaaaabbabbbaaaaaaaaaaaaaaaaaaaaaaaaabbbbbbbbaacccaaaaaaaaabbaaaaaabbbbaaaaaaaaaaaaabbbbbaaaaabbbaaaaabbaaaaabaaa
aaaabbaaaaaabaaaaaaaaaabbaaaaaaaaaaaaaaaaaaaaaaaabbbbbbbaaaaaaaaaaaaaabbaaaaaaabbbaaaaaaaaaaaaaababbbaaaabbbbbaaaabaaaaaabaaa
aaaabaaaaaaabbbaaaaaaaaabbbaaaaaaaaaaaaaaaaaaaaaabbbbbbbaaaaaaaaaaaaaabbaaaaaaaabbaaaaaaaaaaaaaabbbbbaaaabbbbbaaaabbaaaabbaaa
aaabbbbaaaaaaabaaaaaaaaaabbbbaaaaaaaaaaaaaaaaaaaaaabbbaaaaaaaaaaaaaaabbaaaaaaaaabbbaaaaaaaaaaaaaabbbaaaaabbbbbaaaaabaaaaabaaa
aaabbbbaaaaaaabbbaaaaaaaaabbbaaaaaaaaaaaaaaaaaaaaaaaaaaaaaaaaaaaaaaabbbaaaaaaaaaabbabaaaaaaaaaaaaaaaaaaaabbbbaaaaabbbbbaabbaa
aaabbbaaaaaabbbaaaaaaaaabbbbbaaaaaaaaaaabbaaaaaaabbaaaaaaaaaaaaaaaaabbaaaaaaabbbbbbbbbbaaaabaaaaaaaaaaaaaaaabaaaaabbaaaaaabaa
aabbbaaaaaabbaaaaaaaaaaaaabbaaaaaaaaabbbbbbbbbabbbbaaaaaaaaaaaaaaaabbbaaaaaaaabbbbbbbbbbbaabaaaaaaaaaaaaaaaabbaabbbaaaaaaabaa
aabbbaaaaabbaaaaaaaaaaabbbbaaaaaaaaaabbbbbbbbbbbbbbaaaaaaaaaaaaaaabbbbaaaaaaaaaaaabbbbbbbbbbaaaaaaaaaaaaaaaaabbbbbbaaaaaaabaa
aabbbaaabbbbaaaaaaaaabbbaaaaaaaaaaaaaaabbbaabbbbbbbaaaaaaaaaaaaaabbabbbaaaaaaaaaaaaaaaabbbbbaaaaaaaaaaaaaaaaaaaaabbbbbbaaabaa
aabbaaabbaaaaaaaaaaabbaaaaaaaaaaaaaaaaabaaaaabbbbbaaaaaaaaaaaaaaaaaabbbaaaaaaaaaaaaaaaaaaabbaaaaaaaaaaaaabbaaaaabbbaaabbbbbaa
aaabaaabbbbbaaabbbbbbaaaaaaaaaaaaaaaaaaaaaaaabbbbbaaaaaaaaaaaaaaaaaaabbaaaaaaaaaaaaaaaaaaaabaaaaaaaaabbbbbbbbbabbaaaaaabbaaaa
aaabbaaaaaabbbbbbbbbaaaaabbaaaaaaabbbbaaaaaaaaabbaaaaaaaaaaaaaaaaaaabbbaaaaaaaaaabbaaaaaaaabbaaaaaaaabbbbaaaabbbbaaaaaaabaaaa
aaaabaaaaaaaabbaababbbbbbbaaaaaaabbbbbbbbbbaaabbaaaabbaaaaaaaaaaaaabbbbaaaaaaabaabaaaaaaaaaabbabaaaaabbbbaaaaaaabbaaaaaaaaaaa
aaaababbaaaaaabbbbbbaaaaaaaaaaaabbbbbbbbbaaaaabaaaaabbbbbaaaaaaaaaabbabbaaaaaabbabbbbaaaaaaabbabaaaaaaaaaaaaaaaaabbaaaaaaaaaa
aaaabbbbaaaaaaaabbaaaaaaaaaaaaaabbbbbbbbbaaaaabaaaaaabbbbbbaaaaaacbbaabbaaaaaaabbbbbbaabbbbbbbbbddddaaaaaddaaaaaaabaaaaaaaaaa
aaabbbbaaaaaaaaabaaaaaabbbaaaaaabbbbbbbbaaaaaabbaaaaaaabbbbbbaaacbbbaacbbaaaaaaabbbbbbbbaaaabbbbbbbddaaaddbbaaaaaabbaaaaabaaa
aabbbbbaaaaaaaaabaaaaabbbbbbaaaaabbbbbbaaaaaaaabaaaaaaaaaabbbbacbbbaaacbbbaaaaaabbbbbbbaaaabbedbbdfbgaaadbbaaaaaaabbaaaaabaaa
aabbbbaaaabbbbbbbaaaaabbbabbaaaaabbbbbaaaaaaabbbbaaaaaaaaaabbbbbbbbaaaaabbbaaaaabbbbbbbaaaaagbbbbbbbbbaddbbaaaaaabbbaaaabbaaa
aabbbaaaabbaaaaabaabbabbbbbbaaaaaaaaabbaaaaaaabbbbbbaaaaaaaaabbbbbaaaaaaabbaaabbbbbbbbbaaaaaddddbbbbbbbdbbdaaaaabbbbaaabbaaaa
aaaaaaaabbaaaaaabbbbbbbbbbbbbaaaaaaaabbaaaaaaaabbbbbbaaaaaaabbbbaaaaaaaaaaaaaabbbbbbbbbbbbaaaaaddddbbbbbbddaaaaabaababbbaaaaa
aaaaaaaabaaaaaaaabbaaaabbbaabaaaaaaaaabaaaaaaaaabbbbbbbbbbbbbbbaaaaaaaaaaaaaaabbbbbbbbbbbbbaaaaaaaaaadbbbdaaaaaabaabbbbaaaaaa
aaaaaaaabaaaaaaaabaaaaaaaaaabbaaaaaaaabbaaaaaaaaaaaaaaaaaabbabaaaaccaaaaaaaaaaaaaaabbbbbbbbbbaaaaaaaadbbddaaaaaabbabaaaaaaaaa
aaaaaaabbaaaaaaaaaaaaaaaaaaaabaaaaaaaabbbaaaaaaaaaaaaaaaaaaaabaaacbbbbbaaaaaaaaaaaaaaabbbbbbbaaaaaaaddbhaaaaaaaaabbbaaaaaaaaa
aaaaaaabbaaaaaaaaaaaaaaaaaaaabbbbaaaaaabbaaaaaaaaaaaaaaaaaaaabaacbbbbbbbaaaaaaaaaaaaaaaaaaaaaaaaaaaadiidddddddddabbaaaaaaaaaa
aaaaaaaabbbbbbbaaaaaaaaaabbbbbabbaaaaaaabbaaaaaaaaaaaaaabbbbbbbbbbbbbbbbaaaaaaaaaaaaaaaaaaaaaaaaaaaadbhjjjklllldabaaaaaaaaaaa
aaaaaaaabbabbbaaaaaaaaaabbaaaaaabaaaaaaaabaaaaaaaaaaaaaaaabaaaaaabbbbbbbbaaaaaaaaaaaabbbaaaaabbbbaaadbddddddddldabaaaaaaaaaaa
aaaaaaaabbbbbbbbbaaaaaaabaaaaaaabbaaaaaaabbaaaaaaaaaaaaaaabbbbaaabbbbbbbbaaaabbaaaaaaaabaaabbbaabbbbbbbaaaaaadldbbbaaaaaaaaaa
aaaaaaaaabbbbbaabbbaaaabaaaabbbbbbaaaaaaaabbbaaaaaaaaaaaacjcabbaabbbbbbbbaaaaabaaaaaaaahbabbaaaaaaaaaabbbbaaddldbbbhaaaaaaaaa
aaaaaaaaaaabbaaaaabbaaabaaabbaabaaaaaaaabbbbbaabbbaaaaaaacjcaaaaaabbbbbbbaaaaabbaaaaaaaahbbaaaaaaaaaaahbahaadmldbbbhaabbbhaaa
aaaaaaaaaaaaaaaaaaaabbbbbbbbaaabaaaaaaabbbbbbbbbbbaaaaaaacjcabbbaaacccccaaaaaaabbaaaaaaaabaaaaaaaaaaaahbbbaadlldbbbbhbbbhaaaa
aaaaaaaaaaaaaaabbaaabbbbbbbaaaabbaaaaabbabbbbbbbbaaaaaaaaabbbbbbaaaaaaaaaaaaaaaabaaaaaaaabbaaaaaaaaaaababhaaddddbbbbbaahaaaaa
aaaaaaaaaaaaaaaabaaabbbbbbaaaaaabaaaaabbbbbbbbbbbbaaaaaaaabbbbbaaaaaaaaaaaaaaaaabbaaaaaaaabaabbaaaaaaabbbbhaaaaahbbbaaaaaaaaa
aaaaaaaaaabaaaaabaabbbbbbbbbaaaabbaaaabbbbbbbbaaabbbaaaaabbbbaaaaaaaaaaaaaaaaaaaabaabaaaacblbhaaaaaaaabbabbaaaaaahbbaaaaaaaaa
aabbaaaabbbaaaaababbabbaaaabbbaaabbbaabbbbbbbbaaaabbbbabbbaaaaaaaaaaaaaaaaaaaaaaabbbbaaaaclbhaaaaaaaaaahbbaaaaaaaahbbaaaaaaaa
aabbbaabbaaaaaabbbbaaaaaaaaaabaaaaabbbbaaaaaabaaaaabbbbbbaaaaaaaaaaaaaaaaabaaaabbbaaaaaaaclbaaaaaaaaaaabhaaaaaaaaaaabaaaabaaa
aaaabbbbaaabbbbbbaaaaaaaaaaaaaaaaaaaaaaaaaaaaaaaaaabbbbaaaaaaaaaaaaaaaaaabbaaabbaaaaaaaaabbgaaaaaaaaaaaabaaaaaaaaaaabbaabbaaa
aaaabbaaabbbabbbbaaaaaaaaaaaaaaaaaaaaaaaaaaaaaaaaabbabbbaaaaaaaaaaaaaaaaabbaaabaaaaaaaaaabbhaaaaaaaaaaaaaaaaaaaaaaaaababbaaaa
aaaaabbabbaaabbbbaaaaaaaabaaaabbbbaaaaaaaaaaaaabbbbaaaaaaaaaaaaaaaaaaaaaabbdddbaaaddaadddbbhaaaaaaaaaaaaaaaaaaabbaaaabbbaaaaa
aaaaaabbbaaaaaaaaaaaabbbbbaabbbaabbbbaaaaaaaaaabbaaaaaaaaaaaaaaaaaaaaaaaaabbbbbbbadbbddbbhaaaaaaaaaaaaaaaaabbbbbbbbbbbbaaaaaa
aaaaaabbaaaaaaaaaaaabbaaabbbbaaaaabbbbbaaaaaaaaabaaaaaaaaabbbbaaaaaaaaaaaaabbbbbbbdbbbbbaaaaaaaaabhbbaaaabbbaaabbbbbbhaaaaaaa
aaaaabbaaaaabaaaaaabbaaaaaaaaaaaaabaaabbbbaaaaaabbaaaaaabbbbbbbbaaaaaaaaaaaddddddbbblcaaaaaaaaabbbbaaaaaaaaaaaabbbbbbhaaaaaaa
aaaaabbaaaaabaaaaabbaaaaaaaaaaaabbbaabbbbbbbaaaaabbaaaabbbbbbbbbbaaaaaaaaaaaaaaaddbblcaaaaaaaabhbhaaaaaaaaaaaaaabbbbhbaaaaaaa
aabaabaaaaaabaaaaabaaaaaabbbaaaaabaaaabbbbbbbaaaaabbbbabbbbbbbbbbaaaaaaaaaaaaaaaadbbddaaaaaaabbbhaaaaaaaaaaaaaaaaabbbbbbaaaaa
aababbaaaaaabbaaaabbbbbbbbaaaaaabbaaaabbbbbbbaaaaaaabbbbbbbbbbbbbaaaaaaaaaaaaaaaaabblcaaaaaabbhaaaaaaaaaabbaaaaaaabdaaabbaaaa
aabbbaaaaaaaabaabbbbbbbbbaaaabaabaaaaaabbbbbbaaaaaaaabbbbbbbbbbbaaaaaaaaaaaaaaaaaaabbcaaaahbbdaaaaaaaaabbbbaaaaaabhdaaaabaaaa
aaabbaaaaaaaabbbbbbbbbbbbaaabbbbbbbaaaaaaaabaaaaaaaabbbbbbbbbbbaaaaaaaaaaaaaaaaaaadjdaaaahhbndaaaaaaaabbbbbaaaaaabhdaaaahaaaa
aaaabaaaaaaaabbbbbbbbbbbbaaaabbbbbbaaaaaaaaabaaaaaaaaabbbbbbbbbaaaaaaabbbbaaaaaaaadjddaaabhbddaaaaaabbbbbbbaaaaabbbbaaaaaaaaa
aaaabaaaaaaabbbbbbbbbbbbbaaaabbbbbbaaaaaaaaabbaaaaaaaabbbbbaabbaaaaabbbbbaaaaaaaaadbodddabbddaaaaaabbbbbbbbaaaaaphbhaaaaaaaaa
aaaabaaaaaabbaabbbbbbbbbaaaaabbbbaaaaaaaaaaaabaaaaaaaaaaaaaaaabbaaabbbbaaaaaaaaaaccbbbbddbldaaaaaabbbbbbbbbaaaaahbbhaaaaaaaaa
aabbbbaaaabbaaabbbbbbbbaaaaaaaaaaaaaaaabbaaabbbbaaaaaaaaaaaaaabbaabbbaaaaaaaaaaacbbbddbbbbbdaaaaaabbbbbbbbbaaaaahbbbaaaaaaaaa
aababbaaaabaaaaaaabaaabaaaaaaaaaaaaaabbbbbbbbbbbbaaaaabbbbaaaabbbbbbaaaaaaaaaaaaabbbaddblbblbaaaaaaabbbbbbaaaaaabbhbbbaaaaaaa
aabbbaaaaabaaaaaaabaaabbaaaaaaaaaaaabbbbaabbbbbbaaaaabbbbbaaacbbbbaaaaaaaaaaaaaaababaadhbbbbbbbaaaaaabbbbbaaaaaabhbaabbaaaaaa
aaabbaaaaabaaaaaaabaaaabaaaaaaaaaaabbbbaaabbbbbbbbbbabbbbbaaacbbcaaaaaaaaaaabbbaabbbaadddhhblbbbaaaaaabbbaaaaaaaabbaaabbaaaaa
aaaabaaaaaaaaaaaabbaaaabbaaaaaaaabbbbbaaaabbbbaaaaabbbbbbbaaacbbcaaaaaaaaaaababaabbaaaaaaaahbbbbbaaaaaaaaaaaaaaaaaaaaaabaaaba
aaaabaaaaaaabbbaabbaaaaabbaaaaaabbbbbaaaaabbbaaaaaaaaabbbaaaaabbcaaaaaaaaaaabaababaaaaaaaaaaaabbbaaaaaaaaaaaabaaaaaaaaabaabba
aaaabbaaaabbbbbaaabbaaaaabaaaaabbbbaaaaaaaabbaaaaaaaaaabaaaaaabbcaaaaaaaaaaabbababaaaaaaaaaaaaabbbaadddddaaaabbaadddddabbbbaa
aaaaabaaaaaabbaaabbaaaaaaaaaaaabbabaaaaaaaaaaaaaaaaaaaaaaaaaaabbcaaaaaaaaaaaabbbbbbbaaaaaaaaaaabbbaddhhlbbaaaabbadpbbbabaaaaa
aabbbbbbaaaabbaabbbbbbaaaaaaaabbbbbaaaaaaaaaaaaaabbbbaaaaaaaabbaaaaaacccccccagbbbbbbpaaaaaaaaaabbbddbbbbhaaaaaabbbbblbibaaaaa
aababbbbbbbbbbbbbbbbbaaaaaaabbbbaaaaaaaaaaaaaaddbbbbbaaaaaaabbbaaaaaacjjjjjjbbbbbabbbaaaaaaaaaaabbbbbbbhaaaaaaaahblbhbaaaaaaa
aabbbbbbaaaaaabbbbbbbaaaaaaabbbbbbaaaaaaaaaaabbbllddaaaaaaabbbaaaaaaacjcccccbbabbbbbaaaabbbbaaaaabbbblddaaaaaaabbhbbblaaaahaa
aabbbbbaaaaaabbbbbbbbaaaaaaaabbbbbbaaaaaaaabaabllddaaaaaaaaaaaaaaaccccjcaaaaabbbbbaaaaabbbbbaaaaabblbddaaaaaaaabbbbhbaaaabbha
aabbbbaaaaaaabbbbbbbaaabbbbaaaaabbbbaaaaaaabbbblbdaaaaaaaaaaaaaaaacjjjjcaaaaaaaaaaaaaaabbhbbaaaaabbdddaaaaaaabbbhbhbaaaabbbba
aaabbbaaaaaaaabbbbbbaaabbbbaaaaaabbbaaaaaaaabbllbaaaaaaaaaaaaaaaaacjccccaaaaaaaaaaaaaahbbbhbaaaahbbaaaaaaaaaaahhbbblbbjjbhbpa
aaabbaaaaaaaaabbbbbbaaabbbbaaaaaaabbbaaaaaaabblbbbddaaaaaaaaaaaadddjddddaaaaaaaaaaaaaabbbhbaaaaabbaaaaaaaaaaaahhhaaaabaaabhba
aabbaaaaaaaaabbbbbbaaaaabbbaaaaaaadbbaaaaaaabbbblbbbbaaaaaaaaaaadallhlqdaaaaaaaaaaaaaabbbbbaaaahbbaaaaaabbaaaaaabbaaabbaaabaa
aabaaaaaaaaabbbbbbbaaaaaaabaaaaaaadbbaaaaaaabbblllllbdaaaaaaaaaadlqlrlhdaaaaaaaaaaaaaaabbbaaaaahbaaaaaaabhbhbaaabaaaaabaaaaaa
aabbaaaaaaaabbbbaabbaaaaabbbaaaaaadbbbaaaaabbabbbllllbaaaaaaaaaadhlalladaaaaaaaaaaaaaaaaaaaaaadbbdaaaabbpbbbbbaabaaaaabbaaaaa
aaabaaaaaaaaaaaaaabbbaabbbbbbaaaaaabbbaaaaabaaabbbbllbbdaaaaaaaaddddasadaaaaaaabbbbbbaaaaaaaaadbldaaaaaabbbhbhadbadddaabaaaba
aaabbaaaaaaaaaaaaaabbbbbbbbbbaaaaaabbaaaaaabaaaaaabbbbbdaaaaaaaaaaadddddaaaaaaaaaaaabbaaaaaddddbldaaaaaahhbbbaadbblldaabbabba
aaaabbbaaaaaaaaaaaaabbbbbbbbbaaaaabbbaaaaaabbaaaaaaaaaaaaaaaaaaaaaaaaaaaaaaaaaaaaaaaabbaaaabbllbbdaaaaaaaaaabbbdhbthdaaabbhaa
aaaabbbbbbbbbaaaaaabbbbbbbbbaaaaaabbaaaaaaaabbbaaaaaaaaaaaaaaaaaaaaaaaaaaaaaaaaaaaaaaabbbbbbbbbbbbhbhaaaaaaaaabbbhbldaaaabaaa
aaaababbbbbbbbaaaabbaaabbbbbbaaaaabbaaaaaaaaaabbbbaaaaaaaaabbbbbbbbaaaaaaaaaaaaaaaaaabbbbbllbhhbbbbbhaaaaaaaaaaabbhbdaaaabaaa
aaaabbabbbbbabaaaabaaaaabbbabbaaaabaaaaaaaaaaaaaaabbbaaaaabbaaaaaabhaaaaaaaaaaaaaaaabbbhdddddadhgbbbbhaaaaaaaaadllbbaaaaabaaa
aaaaabbbbbbbbbaaabbaaaaaaaaaabaaaabbaaaaaaaaaaaaaaaabbaaabbaaablhabhaaaaaaaaaaaaaaabbbhddaaaaadddllbbbaaabbbaaaddddjdddaabbaa
aaaaaabbaaaaaaaabbaaaaaaaaaaabbaaabbaaaaaaaaaaaaaaaaabaabbaahhbphabaaaaaaaaaaaaaaabbaabaaaaaaaaadddhbbabbbabbaaaaadjjldaaabha
aaaaaabaaaaaaaabbaaaaaaaaaaaaabaaabbbaaaaaaaaaabbbbbabaabaabhblbbbbaaaaaaaaaaaaaabbaadbbdaaaaaaaaaddbbbbdaaabbaaaaaaaldaaabba
aaaaaabaaaaaaabbbbbbaaaaaaabbbbbaabbbaaaaaabbbabbbabbbaababhblbblbaaaaaaaaaaaaaaaaaaadbbdaaaaaaaaaadlblbdaaaabaaaaaabbdaaaaba
aaaaabbaaaaaabbbbbbbaaaaaaabbbbbaaabbbaabbbbababbabbbaaabalblhllbaaaaaaaaaaaaaaaaaaaadbbdaabbaaaaaaalbbldaaabbaaaaabbbbaaaaba
aaabbbbaaaaaabbbbbbaaaaaaaaabbbaaaabbbabbaaaababaabaaaaablblblblbbbaaaaaaaaaaaaaaaaaddbbaabhaaaaaaaahbbbdaaaabaaaabbaabbaabba
aabbbbaaaaaaabbbbbbaaaaaaaabbbbaaaaabbbbaaaaabblaaaaaaaabbbhlblbbbbbbbbaaaaaaaaabbbbbbbbabbaaaaaaaahbbabbbaaabbaaabaaaahbbbaa
aabbbbaaaaaaaaabaaaaaaaaaaabbbbaaaaaabbbaaaaaabblaaaaaaaabllblaaaabbbbbbbaaaaaabbaaadbbbbhaaaaaaaabbdddaabbaaababbhaaaaabbaaa
aabbabaaaaaaaaabaaaaaaaaaaabbbbaaaaaababaaaaaabbbbaaaaaaapbaaaaaaaaabbbbbaaaaaaaaaaaddbbbaaaaaaaaabbdaaaaabbbbbbhaaaaaaabbaaa
aabbbbaaaaaaaaabaaaaaaaaaaaabaaaaaaabbabaaaaaaabbbaaaaaaaaaaaaaaaaaaaabbbaaaaaaaaaaaadbbaaaaaaaaabbddaaaaaaaabaaaaaaaaaabaaaa
aabbbbbbbaaaaaabbaaaaaaaaaaabaaaaaabbaabaaaaaaaalbaaaaaaaaaaaaaaaaaaaabaaaaaaaaaaaaaadbbdaaaaaaaabbdaaaaaaaaabaaaaaaaaaabaaaa
bbbbabbbbbaaaaaabaaaaaaaaaaabaaaaaabbaabbaaaaaaablbbaaaaaaaaaaaaaaaaaabaaaaaaaaaaaaabbbbdaaaaaaaabbaaabbbbaaabaaaaaaaaabbaaaa
bbaaabbbbbbaaaaabbaaaaaaaaaabbaaaabbaaaabaaaaaaaaablbaaaaaaaaaaaaaabbbbaaaaaaaaaabbbbabhdaaaaaaabbbbbbbbbbbbaabaaaaaaaaabbaaa
aaaaaabbaabbaaaaabbaaaaaaaaaabaaaabbaaaabaaaaaaaaabblbaaaaaaaaaaaablhhaaaaaabbbbbbaaaaaaaaaaaaaaaaaabbbhbbbaaabbbaaaaaaaabaaa
aaaaaaaaaaabbbaaaabbaaaaaaaaabbbbbbaaaaabbaaaaaaaaaabbbbaaaabbbbbblhaaaaaaaaaaaaaaaaaaaaaaahhaaaaaaabhbbhbbaaababbbaaaaaabaaa
aaaaaaaaaabbbbbaaaabbaaaaaaaaaaaaaaaaaaaabbaaaaaaaaaabbbaaabbqqaaaaaaaaaaaaaaaaaaaaaaaaaaabbbhaaaaaaaaaaaaaaabhaaahaaddbbhbda
aaaaaaaaaabbbbbaaaaabaaaaaaaaaaaaaaaaaaaaabbbaaaaaaaaabbbbbbaaaaaaaaaaaaaaaaaaaaaaaaaaaahbbaabhaaaaaaaaaaaaabhaaaaaaadbalbbda
aaaaaaaaaaabbbbaaaaabbaaaaaaaaaaaaaaaaaaaabbbaaaaaaaaaaaaabbaaaaaaaaaaaaaaaaaaaaaaaaaaaabaaaaabhhaaaaaaaaaabbaaaaaaaadpbbbada
aaaaaaaaaabbbbbaaaaabbbbbabaaaaaaaaaaaaaabbbbaaaaaaaaaaaaaaaaaaaaaaaaaaaaaaaaaaaaaaaaaahbaaaaalbbbbpaaaaabbbaaaaaaaaadhublbda
aaaaaaaaabbaabaaaaaaabbbbbbbaaaaaaaaaabbbbbbbbbbbaaaaaaaaaaaaaaaaaaaaadddvddaaaaaaaaaaababbaaabbabbbbbabbbbbaaaaaaaaadbbbbhaa
aaaaaaaaabaaaaaaaaaaaaabbbbbaaaaaaabbbbbbbbbbbbbbbaaaaaaaaaaaaaaaaaadddwqwhhqwaaaaaaaaaaabdaaaabbbablaaaaabaaaaaaaaaaabbbhaaa
aaaaaaaaabbaaaaaaaaaaaaabbbaaaaaaaaabbbbbbbbbbbbbbaaaaaaaaaaaaaaaaaawwqqbqbbbqwaaaaaaaaaabdaaaaaaabbaaaaaabhaaaaaaaaabblhhdaa
aaaaaaaaaabaaaaaaaaaaaaababaaaaaaaaabbbbbbbbbbbbbbblbaaaaaaaaaaaaaawqbbbhqqhwqbqaaaaaaaaabdaaaaablbaaaaabbbbaadddddabbaddddaa
aaaaaaaaaabbbbbbaaaaaaaaaabbaaaaaaaabbbbbbbbbbbbbbbblbbaaaaaaaaaawqbbwhqbwhqwwqbqaaaaaaabbdaaaablaaaaabbbaabaadbbbdbbaaaaaaaa
aaaaaaaaaabbbbbbbaaaaaaaaaabbbaaaaaabbbbbbbbbbbbbbbbbblaaaaaaaaawbbhwwhhwwwhqwwhbdddaaabhaaaaaabaaaaabldaaabbadhbbbbaaaaaaaaa
aaaaaaaaaabbbbbbbbaaaaaaaaaabbaaaaaabbbbbbbbbbbbbbbbbblaaaaaaaaabqhwwbwbwwwbbhqhqbbdabbhaaaaaaabaaaablddaaaabbbbhbbaaaaaaaaaa
aaaaaaaaaaabbbbbbbaaaaaaaaaabbbbbaaabbbbbbbbbbbbbbbbblaaaaaaaaaabbbbhwwwqwwwqbqbqbqbbqaaaaaaaaabbaaabddaaaaaabblbhhbbaaaaaaaa
aaaaaaaaaaaaabbbbaaaaaaaaaaabbbbbaaabbbbbbbbbbbbbbbbblaaaaaaaaaaqwqhqwwqwwwwbhbbhqhqhaaaaaaaaaadbbbabdaaaaaablhhhlhhldaaaaaaa
aaaaaaaaaaaaabbbaaaaaaaaaaabbbbbbaaaabbbbbbbbbbbbbbbbbaaaaaaaaaawqbbqwwwwwwbqbwhbbqhaaaaaaaaaaadddbbbdaaaaaxblhhhhhbldaaaaaaa
aaaaaaaaaaaaabbaaabbbbaaaaabbbbbaaaaaabbbbbbbbbbbbbbbbaaaaaaaaaabwwbbwbqwqwqbwwqwbbdaaaaaaaaaaaaadddbdaaaaabbhhlbbhbddaaaaaaa
aaaaaaaaaaaaaabbbbbbbbbbbbbbbbbaaaaaaaaaabllbbbbbbbbbaaaaaaaaaaaabwwhqwbwwwqbqwwbhddaaaaaaaaaaaaaaadbbbabbbbbbbbhbpddaaaaaaaa
aaaaaaaaaaaaaaaaabbbbbbaaaabbaaaaaaaaaaaaaaaallbbbbbaaaaaaaaaaaaabbwbbwwwwwwhbqbhqdaaaaaaaaaaaaaaaaaaabbbdddaaaaadddaaaaaaaaa
aaaaaaaaaaaaaaaaaaaabaaaaaaaaaaaaaaaaaaaaaaaaaaaaaaaaaaaaaaaaaaaaaabbhqwwwwwwbbqwwaaaaaaaaaaaaaaaaaaadddddaaaaaaaaaaaaaaaaaaa
aaaaaaaaaaaaaaaaaaaaaaaaaaaaaaaaaaaaaaaaaaaaaaaaaaaaaaaaaaaaaaaaaaaaaaahqwwwqhqwbaaaaaaaaaaaaaaaaaaaaaaaaaaaaaaaaaaaaaaaaaaaa
aaaaaaaaaaaaaaaaaaaaaaaaaaaaaaaaaaaaaaaaaaaaaaaaaaaaaaaaaaaaaaaaaaaaaaaaddddaaaaaaaaaaaaaaaaaaaaaaaaaaaaaaaaaaaaaaaaaaaaaaaaa
aaaaaaaaaaaaaaaaaaaaaaaaaaaaaaaaaaaaaaaaaaaaaaaaaaaaaaaaaaaaaaaaaaaaaaaaaaaaaaaaaaaaaaaaaaaaaaaaaaaaaaaaaaaaaaaaaaaaaaaaaaaaa
"}
